#####    B  ####
##### ##### ####
###   ##### ####
##   ######    #
A              #