############
# A#      ##
#  ## ######
#    #    ##
#### ## ## #
#    #  # ##
# ####  # ##
# #    ## ##
# ## ##### #
#    #    ##
## #   ## ##
######B#####
